0     0ss   0
  ssss    s  
  s   m sss  
 s   ss   s  
    sss   ss 
 s ssss s    
 s ss   ss   
m   s sss  s 
 ss   ssm  s 
 s    ss  ss 
 sss  m  s   
     mmm   ss
ss  1mbm2    