0  s  0s    0
 m s   m m m 
 m    mm msm 
   m     s   
m  m  s  m ms
     m  s    
 mmm   s   m 
     m m m m 
 m   m m   m 
 m m mmm msm 
 m m mmm     
 m   mmm m m 
 m m1mbm2mmm 