0     0     0
 m m m m m m 
 m m m m m m 
 m m msm m m 
 m m     m m 
 m m     m m 
     m m     
s mm     mm s
     mmm     
 m m     m m 
 m m     m m 
 m m mmm m m 
    1mbm2    