0  m  0  s  0
m     s  ss m
  ss sss s   
 sss  s      
  s          
             
sm ss   ss ms
    s    s   
             
m  ss   ss  m
m   ss ss   m
  m  mmm  m  
  mm1mbm2 m  