0   mm0     0
s m m   sss  
s m   m      
m mmm mm ww w
m   m    w   
    ww www mm
mm  wm m     
    w      s 
www w s m  s 
   mm      sm
    mmmmm    
mmm  mmm mm  
mm  1mbm2    