0  w  0 w   0
ww w wwww www
  m  m  w w w
mwwww s  m   
   w  w wwwwm
ww w ww  w   
  m m m  w  w
 ww wwww  m w
m  m  w m w w
ww ww wmwww  
  m      w  w
 www mmm w ww
 w  1mbm2    