0  s m0m m s0
 m m     s   
 m m  s  s ss
 m   m sm   s
    mm mm s  
  s m  mm mm 
s s  m s  sm 
  mm m   ms  
 smm mm mm  m
 m   ms    mm
   m mms s  m
m mm mmm ms  
m m 1mbm2mmm 