0   s 0     0
ss  s  ss    
 s  s   s ssm
 s  sss m s  
 m    s sss  
wss smsmm    
  sms   m  ss
  s     s  s 
  m  s  ssms 
 sss  mss ms 
   m       m 
   s mmm   m 
   s1mbm2s m 